接口名称（中文）	接口名称（中文）
沪深股票日行情	getMktEqud
港股日行情	getMktHKEqud
沪深大宗交易	getMktBlockd
债券日行情	getMktBondd
债券回购日行情	getMktRepod
期货日行情(主力以持仓量计算)	getMktFutd
期货会员多头持仓排名	getMktFutMLR
期货会员空头持仓排名	getMktFutMSR
期货会员成交量排名	getMktFutMTR
基金日行情	getMktFundd
指数日行情	getMktIdxd
获取多只股票历史上某一天的因子数据	getStockFactorsOneDay
获取多只股票历史上某一时间段的因子数据	getStockFactorsDateRange
股票基本信息	getEqu
股票首次上市信息	getEquIPO
股票分红信息	getEquDiv
股票配股信息	getEquAllot
股票股权分置	getEquRef
股票拆股信息	getEquSplits
股票每日回报率	getEquRetud
股票行业分类	getEquIndustry
沪深融资融券每日汇总信息	getFstTotal
沪深融资融券每日交易明细信息	getFstDetail
基金基本信息	getFund
基金历史净值(货币型,短期理财债券型除外)	getFundNav
基金历史收益(货币型,短期理财债券型)	getFundDivm
基金净值调整	getFundDiv
基金资产配置	getFundAssets
基金持仓明细	getFundHoldings
ETF基金申赎清单基本信息	getFundETFPRList
ETF基金申赎清单成分券信息	getFundETFCons
指数基本信息	getIdx
指数成分构成	getIdxCons
期货合约信息	getFutu
港股基本信息	getHKEqu
沪深证券停复牌	getSecHalt
业绩快报 (Point in time)	getFdmtEe
证券编码及基本上市信息	getSecID
期货主力、连续合约日行情	getMktMFutd
沪深股票前复权行情	getMktEqudAdj
沪深股票前复权因子	getMktAdjf
期权日行情	getMktOptd
交易所交易日历	getTradeCal
期权基本信息	getOpt
期权品种信息	getOptVar
期货日行情(主力以成交量计算)	getMktFutdVol
沪深涨跌停限制	getMktLimit
沪深股票/新三板键盘精灵	getEquInfo
沪深股票今日停复牌	getSecTips
沪深股票地域分类	getSecTypeRegionRel
地域分类	getSecTypeRegion
证券板块成分	getSecTypeRel
证券板块	getSecType
行业分类标准	getIndustry
分级基金基本信息	getFundLeverageInfo
参数常量值集合	getSysCode
沪深股票ST标记	getSecST
合并资产负债表(所有会计期末最新披露)	getFdmtBSAllLatest
银行业资产负债表(所有会计期末最新披露)	getFdmtBSBankAllLatest
证券业资产负债表(所有会计期末最新披露)	getFdmtBSSecuAllLatest
一般工商业资产负债表(所有会计期末最新披露)	getFdmtBSInduAllLatest
保险业资产负债表(所有会计期末最新披露)	getFdmtBSInsuAllLatest
业绩快报(所有会计期末最新披露)	getFdmtEeAllLatest
合并现金流量表(所有会计期末最新披露)	getFdmtCFAllLatest
银行业现金流量表(所有会计期末最新披露)	getFdmtCFBankAllLatest
证券业现金流量表(所有会计期末最新披露)	getFdmtCFSecuAllLatest
一般工商业现金流量表(所有会计期末最新披露)	getFdmtCFInduAllLatest
保险业现金流量表(所有会计期末最新披露)	getFdmtCFInsuAllLatest
合并利润表(所有会计期末最新披露)	getFdmtISAllLatest
银行业利润表(所有会计期末最新披露)	getFdmtISBankAllLatest
证券业利润表(所有会计期末最新披露)	getFdmtISSecuAllLatest
一般工商业利润表(所有会计期末最新披露)	getFdmtISInduAllLatest
保险业利润表(所有会计期末最新披露)	getFdmtISInsuAllLatest
个股日资金流向	getMktEquFlow
行业日资金流向	getMktIndustryFlow
基金前复权行情	getMktFunddAdjBf
期货仓单日报	getMktFutWRd
指数成分股权重	getIdxCloseWeight
股票日资金流向单类明细	getMktEquFlowOrder
行业日资金流向单类明细	getMktIndustryFlowOrder
可转债价格变动	getBondConvPriceChg
投资者情况统计	getInvestorsStats
期权交易统计	getMktOptStats
股票周行情	getMktEquw
股票周前复权行情	getMktEquwAdj
股票月行情	getMktEqum
股票月前复权行情	getMktEqumAdj
外汇牌价	getMktFxQtRate
公司基本信息	getPartyID
沪深交易公开信息_股票(龙虎榜)	getMktRankListStocks
沪深交易公开信息_营业部(龙虎榜)	getMktRankListSales
沪港通额度信息	getequSHHKQuota
基金经理	getFundManager
经济日历	getRrpEcoCalendar
行业成分换手率排名	getMktRANKInstTr
财务衍生数据(根据所有会计期末最新披露数据计算)	getFdmtDer
利润表附注-财务费用(所有会计期末最新披露)	getFdmtIsFinexpPS
财务指标—每股(根据所有会计期末最新披露数据计算)	getFdmtIndiPS
财务指标—成长能力(根据所有会计期末最新披露数据计算)	getFdmtIndiGrowth
财务指标—盈利能力(根据所有会计期末最新披露数据计算)	getFdmtIndiRtn
财务指标—营运能力(根据所有会计期末最新披露数据计算)	getFdmtIndiTrnovr
财务衍生数据 (Point in time)	getFdmtDerPit
财务指标—每股 (Point in time)	getFdmtIndiPSPit
财务指标—成长能力 (Point in time)	getFdmtIndiGrowthPit
财务指标—盈利能力 (Point in time)	getFdmtIndiRtnPit
财务指标—营运能力 (Point in time)	getFdmtIndiTrnovrPit
沪深股票成交量复权因子	getMktVolAdjf
A股机构调研活动统计	getEquIsActivity
A股机构调研活动明细	getEquIsParticipantQa
期货月行情	getMktFutm
财务指标-偿债能力(根据所有会计期末最新披露数据计算)	getFdmtIndiLqd
财务指标-利润表结构分析(根据所有会计期末最新披露数据计算)	getFdmtIndiStctIS
财务指标-收现能力(根据所有会计期末最新披露数据计算)	getFdmtIndiCash
证券交易时间	getSecTradeTime
期货涨跌停限制	getMktFutLimit
新股上市连板天数	getMktIpoConTraddays
沪港通每日成交统计	getequSHHKstatsTD
沪港通十大成交活跃股	getequSHHKTDTen
增发	getEquSpo
股票定增信息	getEquPrivateFloat
IPO上市首日表现	getEquIpoPerformance
财务指标-资产负债表结构分析(根据所有会计期末最新披露数据计算)	getFdmtIndiStctBS
银行业现金流量表（单季度，根据所有会计期末最新披露数据计算）	getFdmtCFBankQ
一般工商业现金流量表（单季度，根据所有会计期末最新披露数据计算）	getFdmtCFInduQ
保险业现金流量表（单季度，根据所有会计期末最新披露数据计算）	getFdmtCFInsuQ
合并现金流量表（单季度，根据所有会计期末最新披露数据计算）	getFdmtCFQ
证券业现金流量表（单季度，根据所有会计期末最新披露数据计算）	getFdmtCFSecuQ
银行业利润表（单季度，根据所有会计期末最新披露数据计算）	getFdmtISBankQ
一般工商业利润表（单季度，根据所有会计期末最新披露数据计算）	getFdmtISInduQ
保险业利润表（单季度，根据所有会计期末最新披露数据计算）	getFdmtISInsuQ
合并利润表（单季度，根据所有会计期末最新披露数据计算）	getFdmtISQ
证券业利润表（单季度，根据所有会计期末最新披露数据计算）	getFdmtISSecuQ
单季度财务衍生数据（根据所有会计期末最新披露数据计算）	getFdmtDerQ
单季度财务指标（根据所有会计期末最新披露数据计算）	getFdmtIndiQ
行业估值信息	getMktIndustryEval
沪深股息率排名	getMktRankDivYield
可转债折溢价信息	getMktConsBondPremium
新股上市	getEquChmIpo
年薪区间	getEquSalaryRange
次新股日行情	getMktSubnewEqud
AH股比价	getMktAHCompd
个股企业性质	getEquPartyNature
高管及相关人员持股变动	getEquMsChanges
股权激励基本资料	getEquSharesExcit
深港通额度信息	getequSZHKQuota
深港通每日成交统计	getequSZHKstatsTD
深港通十大成交活跃股	getequSZHKTDTen
公司十大股东（新）	getEquShTen
首发限售解禁明细	getEquIpoShareFloat
股改限售解禁明细	getEquReformShareFloat
股改日历	getEquRefDate
公司十大流通股东(新)	getEquFloatShTen
限售股解禁	getEquSharesFloat
新股网下发行配售结果	getEquIpoUndernetDet
上市A股定期报告预披露	getEquReportPredisclo
上市公司管理层	getEquManagers
公司高管持股薪酬明细	getEquExecsHoldings
上市公司实际控制人	getEquActualController
货币市场参考利率	getMktRefIr
交易市场日度成交概况	getMktExTdShsz
配股认购结果表	getEquAllotmentSubscriptionResults
公开增发中签率及配售结果	getEquSpoPubResult
上市公司关联交易	getEquRelatedTransaction
IPO发行时间安排表	getEquIpoPlan
股票周质押信息	getEquStockPledge
股东大会召开信息	getEquShareholdersMeeting
行业板块区间行情信息	getMktIndustryQuote
指数季行情	getMktIdxq
指数半年行情	getMktIdxs
指数年行情	getMktIdxa
股票季行情	getMktEquq
股票季前复权行情	getMktEquqAdj
股票半年行情	getMktEqus
股票半年前复权行情	getMktEqusAdj
股票年行情	getMktEqua
股票年前复权行情	getMktEquaAdj
港股市场概况	getHKmktPro
每日股票最新表现	getMktEquPerf
可转债转股明细	getBondConvDetail
上市公司股东户数	getEquShareholderNum
融资融券标的证券	getVfsttarget
可转债转股条款	getBondConvStokItem
工作日安排日历	getWorkingCal
财务指标-杜邦分析	getFdmtIndiDupont
新股中签号码	getEquIPOlotto
老股东公开发售明细	getEquOldShoffer
证监会批文	getEquCsrcList
行业板块日行情	getMktInstEqud
可转债市场表现	getMktConsBondPerf
可转债发行（新）	getBondConvIssueNew
股票简称与代码变更查询	getSecChgHistory
可转债发行基本资料	getBondConv
基金前十名持有人持有基金份额情况	getFundMainHolder
基金主要财务指标	getFundMainIndi
公募基金费率	getFundFee
A股券商月报	getFdmtMonthdataSecu
基金代码关联	getFundRel
股票市场统计	getMktEqudStats
可充抵保证金证券	getEquMarginSec
股票区间资金流向	getMktEqunMf
行业区间资金流向	getMktIndnMf
基金净值增长	getFundNavGr
基金经理基本信息	getFundManagerInfo
公司名称变更	getInstNameChg
证券代码对应	getSecSymbol
分类目录	getTypeList
国家代码	getCountry
人物主表	getPeople
公司股本变动(新)	getEquSharesChg
A股公司股权质押	getEquPledge
主营业务构成	getFdmtMoStdItem
主营业务构成（基础数据）	getFdmtMainOperN
基金行业配置	getFundInvestIndustry
基金发行与上市	getFundIssue
基金投资风格	getFundInvestStyle
基金利润分配情况	getFundProfDist
沪深封板信息	getMktLimitStats
沪深估值信息	getMktEqudEval
网下配售统计	getEquIpoUndernetSta
业绩预告(新)	getFdmtEfNew
研发支出信息	getFdmtRdInfo
股票日行情指标	getMktEqudInd
股东增减持计划	getEquChangePlan
(新准则)合并资产负债表 (Point in time)	getFdmtBs2018
(新准则)保险业资产负债表 (Point in time)	getFdmtBsInsu2018
(新准则)一般工商业资产负债表 (Point in time)	getFdmtBsIndu2018
(新准则)银行业资产负债表 (Point in time)	getFdmtBsBank2018
(新准则)一般工商业现金流量表 (Point in time)	getFdmtCFIndu2018
(新准则)保险业现金流量表 (Point in time)	getFdmtCFInsu2018
(新准则)证券业利润表	getFdmtISSecuLT2018
(新准则)银行业利润表	getFdmtISBankLT2018
(新准则)保险业利润表	getFdmtISInsuLT2018
(新准则)一般工商业利润表	getFdmtISInduLT2018
(新准则)合并利润表	getFdmtISLT2018
(新准则)合并现金流量表 (Point in time)	getFdmtCF2018
(新准则)证券业现金流量表 (Point in time)	getFdmtCFSecu2018
(新准则)证券业资产负债表 (Point in time)	getFdmtBsSecu2018
(新准则)合并资产负债表	getFdmtBSLT2018
(新准则)一般工商业资产负债表	getFdmtBSInduLT2018
(新准则)保险业资产负债表	getFdmtBSInsuLT2018
(新准则)银行业资产负债表	getFdmtBSBankLT2018
(新准则)证券业资产负债表	getFdmtBSSecuLT2018
(新准则)银行业现金流量表	getFdmtCFBankLT2018
(新准则)保险业现金流量表	getFdmtCFInsuLT2018
(新准则)一般工商业现金流量表	getFdmtCFInduLT2018
(新准则)证券业现金流量表	getFdmtCFSecuLT2018
(新准则)合并现金流量表	getFdmtCFLT2018
(新准则)银行业现金流量表 (Point in time)	getFdmtCFBank2018
(新准则)银行业利润表 (Point in time)	getFdmtISBank2018
(新准则)一般工商业利润表 (Point in time)	getFdmtISIndu2018
员工人均薪酬	getFdmtAvgSalEmpl
(新准则)合并利润表 (Point in time)	getFdmtIS2018
(新准则)保险业利润表 (Point in time)	getFdmtISInsu2018
(新准则)证券业利润表 (Point in time)	getFdmtISSecu2018
国证月度权重	getCniIdxmWeight
(新准则)财务指标(Point in time)	getFdmtMainDataPIT
(新准则)单季度财务指标(Point in time)	getFdmtMainDataQPIT
(新准则)财务指标(Last time)	getFdmtMainDataLt
(新准则)单季度财务指标(Last time)	getFdmtMainDataQLt
申万月度权重	getSwIdxmWeight
A股精选精品因子数据	getEquFancyFactorsLite
宏观行业-中国宏观重点指标	getEcoDataChinaLite